{
  "mercer": [
    "100001",
    "100002",
    "100003",
    "100004",
    "100005",
  ],
  "mercer": [
    "100006",
    "100007",
    "100008",
    "100009",
    "100010",
    "100053",
    "101179",
    "101180"
  ],
  "brookfield-hubbard": [
    "100011",
    "100045",
    "100046",
    "100047",
    "100048",
    "100049",
    "100050",
    "101172",
    "101173",
    "101174"
  ],
  "shenango-valley": [
    "100012",
    "100013",
    "100014",
    "100015",
    "100016",
    "100017",
    "100018",
    "100019",
    "100020",
    "100021",
    "100022",
    "100023",
    "100024",
    "100025",
    "100026",
    "100027",
    "100028",
    "100029",
    "100030",
    "100031",
    "100032",
    "100033",
    "100034",
    "100035",
    "100036",
    "100037",
    "100038",
    "100039",
    "100040",
    "100041",
    "100042",
    "100044",
    "100054",
    "100086",
    "101171",
    "101175",
    "101176",
    "101177",
    "101178",
    "101181",
    "101182",
    "101183",
    "101184",
    "101185",
    "101186",
    "101187",
    "101188"
  ],
  "greenville": [
    "100055",
    "100056",
    "100058",
    "100059",
    "100060",
    "100061",
    "100062",
    "100063",
    "100064",
    "100065",
    "100066",
    "100067",
    "100068",
    "100070",
    "101166",
    "101169",
    "101170"
  ],
  "stoneboro": [
    "100075",
    "100076",
    "100077",
    "100078"
  ],
  "grove-city": [
    "100080",
    "100081",
    "100082",
    "100083",
    "100084",
    "100085",
    "100087",
    "100088",
    "100089",
    "100090",
    "100091",
    "100092",
    "100093",
    "100094",
    "100095",
    "100096",
    "100100",
    "100245",
    "100703",
    "101167",
    "101168",
    "101205",
    "101206",
    "101207"
  ],
  "slippery-rock": [
    "100102",
    "100103",
    "100104",
    "100105",
    "100106",
    "100107",
    "100108",
    "100109",
    "100113",
    "100120",
    "101208"
  ],
  "butler": [
    "100142",
    "100143",
    "100144",
    "100145",
    "100146",
    "100147",
    "100148",
    "100150",
    "100151",
    "100152",
    "100153",
    "100154",
    "100156",
    "100157",
    "100167",
    "100168",
    "100169",
    "100170",
    "100172",
    "100174",
    "100176",
    "100177",
    "100178",
    "100179",
    "100183",
    "100184",
    "100185",
    "100190",
    "100191",
    "100192",
    "100193",
    "100242",
    "100762",
    "101210"
  ],
  "ellwood-city": [
    "100199",
    "100202",
    "100203",
    "100204",
    "100205",
    "100206",
    "100207",
    "100211",
    "100247",
    "101023",
    "101024"
  ],
  "new-castle": [
    "100212",
    "100220",
    "100221",
    "100222",
    "100223",
    "100225",
    "100226",
    "100227",
    "100228",
    "100229",
    "100230",
    "100231",
    "100232",
    "100233",
    "100234",
    "100235",
    "100236",
    "101198",
    "101199",
    "101200",
    "101201",
    "101211",
    "101212"
  ]
}